NO ./images/dir_n.xpm
SO ./images/dir_s.xpm
WE ./images/dir_w.xpm
EA ./images/dir_e.xpm

C 52,235,219
F 38,189,0

11111111111111111111111111111111111
1E000000000000000000000000000000001
10000000000000000000000011111111111
10000000000000000000000011111111111
10000000000000000000000011111111111
10000000000000000000000011111111111
100000000000000000000000111111111
111111111011000001110000000000001
100000000011000001110111111111111
11110111111111011100000010001
11110111111111011101010010001
11000000110101011100000010001
10000000000000001100000010001
10000000000000001101010010001
1100000111010101111101111000111
11110111 1110101 101111010001
11111111 1111111 111111111111