1111111111
1P00000001
1000111101
10000001C1
1111110111
1C000000E1
1111111111
